4, -4.96998,-0.45,9.72008, 1,1,1, 0,0,0
2, 0,10,50, 1,0,5, 0,90,90
2, -1,0,0, 10,0,10, 0,0,0
2, -50,10,0, 1,0,5, 0,0,90
2, 99,10,0, 1,0,10, 0,0,90
2, 0,10,-50, 1,0,5, 0,90,90
2, 50,10,0, 1,0,5, 0,0,90
1, 5,10,0, 1,1,1, 0,0,0
